; First level
;#####0#######
;#@         .#
;########0####

; Testing a non-simple level
##############
# ##  #####  #
# ###   ##  ##
#      ####  #
######      ##
##############